3,3,3,3,3,3,3,3,3,3,3,3,3,3,3,3,3,3,3,3,3,3
3,0,0,0,0,0,0,0,0,0,0,0,0,0,0,0,0,0,0,0,0,3
3,0,0,12,0,0,0,0,0,0,0,0,0,0,0,0,0,0,0,0,0,3
3,0,0,12,0,0,0,0,0,0,0,0,0,0,0,0,0,0,12,0,0,3
3,0,0,12,0,0,0,0,0,12,12,12,12,12,0,0,0,0,0,0,0,3
3,0,0,12,0,0,0,0,0,0,0,0,0,0,0,0,0,0,0,0,0,3
3,0,0,12,0,0,0,0,0,0,0,0,0,0,0,0,0,12,0,0,0,3
3,0,0,0,0,0,0,0,0,0,0,0,0,0,0,0,0,0,0,0,0,3
3,0,0,0,0,0,12,0,0,12,0,0,0,0,0,0,0,0,0,0,0,3
3,0,0,0,0,0,0,0,0,12,0,0,0,0,0,12,12,12,12,0,0,3
3,0,0,0,12,0,0,0,0,12,0,0,0,0,0,12,12,12,12,0,0,3
3,0,0,0,0,0,0,0,0,12,0,0,0,0,0,12,12,12,12,0,0,3
3,0,0,0,0,0,12,0,0,12,0,0,0,0,0,12,12,12,12,0,0,3
3,0,0,0,0,0,0,0,0,12,0,0,0,0,0,0,0,0,0,0,0,3
3,0,0,0,0,0,0,0,0,0,0,0,0,0,0,0,0,0,0,0,0,3
3,3,3,3,3,3,3,3,3,3,3,3,3,3,3,3,3,3,3,3,3,3
