{ 3,3,3,3,3,3,3,3,3,3,3,3,3,3,3,3,3,3,3,3,3,3,3,3,3,3,3,3,3,3,3,3,3,3,3,3,3,3,3,3,3,3,3 },
{ 3,3,3,3,3,3,3,3,3,3,3,3,3,3,3,3,3,3,0,0,3,0,0,0,3,3,3,3,3,3,3,3,3,3,3,3,3,3,3,3,3,3,3 },
{ 3,3,3,3,3,3,3,3,3,3,3,3,3,3,3,3,3,3,0,0,0,0,0,0,3,3,3,3,3,3,3,3,3,3,3,3,3,3,3,3,3,3,3 },
{ 3,3,3,3,3,3,3,3,3,3,3,3,0,0,0,0,0,3,0,0,0,0,0,0,3,3,3,3,3,3,3,3,3,3,3,3,3,3,3,3,3,3,3 },
{ 3,3,3,3,3,3,3,3,3,3,3,3,0,0,0,0,0,3,0,0,3,3,0,3,3,3,3,3,3,3,3,3,3,3,3,3,3,3,3,3,3,3,3 },
{ 3,3,3,3,3,3,3,3,3,3,3,3,0,0,3,0,0,3,0,0,3,0,0,0,0,0,0,0,3,3,3,3,3,3,3,3,3,3,3,3,3,3,3 },
{ 3,3,3,3,3,3,3,3,3,3,3,3,0,0,0,0,0,3,0,0,3,3,3,3,3,3,3,0,3,3,3,3,3,3,3,3,3,3,3,3,3,3,3 },
{ 3,3,3,3,3,3,3,3,3,3,3,3,0,0,3,0,0,3,0,0,3,3,3,3,3,3,0,0,0,0,0,0,3,0,3,3,3,3,3,3,3,3,3 },
{ 3,3,3,3,3,3,3,3,3,3,3,3,0,0,0,0,0,3,0,0,3,3,3,3,3,3,0,0,0,0,0,0,0,0,3,3,3,3,3,3,3,3,3 },
{ 3,3,3,3,3,3,3,3,3,3,3,3,0,0,0,0,0,3,0,0,3,3,3,3,3,3,3,3,3,3,3,3,0,0,3,3,3,3,3,3,3,3,3 },
{ 3,3,3,3,3,3,3,3,3,3,3,3,3,3,3,0,3,3,0,0,3,3,3,3,3,3,0,0,0,0,0,0,0,0,3,3,3,3,3,3,3,3,3 },
{ 3,3,3,3,3,3,3,3,3,3,3,3,3,3,0,0,0,3,0,0,3,3,3,3,3,3,0,0,0,0,0,0,3,0,3,3,3,3,3,3,3,3,3 },
{ 3,3,3,3,6,3,3,3,3,3,3,3,3,3,0,0,0,0,0,0,3,3,3,3,3,3,3,3,3,3,3,3,3,0,3,3,3,3,3,3,3,3,3 },
{ 3,3,3,0,0,0,3,3,3,3,3,3,3,3,0,0,0,0,0,0,3,3,3,3,3,3,0,0,0,0,0,0,0,0,3,3,3,0,0,0,0,0,3 },
{ 3,3,11,0,0,0,13,3,3,3,3,3,3,3,0,0,0,3,0,0,3,3,3,3,3,3,0,3,3,3,3,3,3,3,3,3,3,0,0,0,3,3,3 },
{ 3,3,3,0,0,0,3,3,3,3,3,3,3,3,3,0,3,3,0,0,3,3,3,3,3,3,0,0,0,0,0,0,3,3,3,3,3,0,0,0,3,3,3 },
{ 3,3,11,0,0,0,11,3,3,3,3,3,3,3,0,0,0,3,0,0,0,0,3,3,3,3,0,3,0,0,3,0,3,3,3,3,3,0,0,0,3,3,3 },
{ 3,3,3,0,0,0,3,7,3,3,3,3,3,3,0,0,0,0,0,0,0,0,3,3,3,3,0,3,0,0,3,0,3,3,3,3,3,3,0,3,3,3,3 },
{ 3,3,11,0,0,0,0,0,0,0,0,0,0,3,0,0,0,0,0,0,0,0,3,3,3,3,0,0,0,0,0,0,3,3,3,3,3,0,0,0,3,3,3 },
{ 3,3,3,0,0,0,3,0,0,0,0,0,0,3,0,0,0,3,0,0,0,0,3,3,3,3,3,3,3,0,0,3,3,0,0,0,0,0,0,0,3,3,3 },
{ 3,3,13,0,0,0,3,3,3,3,3,0,0,3,3,0,3,3,0,0,0,0,3,0,0,0,0,0,0,0,0,0,3,0,0,0,3,0,0,0,3,3,3 },
{ 3,3,3,0,0,0,3,12,12,12,3,0,0,3,0,0,0,3,0,0,0,0,3,3,0,3,3,3,3,3,3,3,3,3,3,3,3,0,3,3,3,3,3 },
{ 3,3,11,0,0,0,0,0,0,12,3,0,0,0,0,0,0,3,0,0,0,0,3,0,0,0,0,0,0,0,0,0,3,0,0,0,0,0,0,3,3,3,3 },
{ 3,3,3,0,0,0,3,12,12,12,3,0,0,3,0,0,0,3,0,0,3,3,3,0,0,0,0,0,0,0,0,0,3,0,0,0,0,0,0,3,3,3,3 },
{ 3,3,3,3,0,3,3,11,3,13,3,3,3,3,3,3,3,3,3,3,3,3,3,3,0,3,3,0,3,3,3,3,3,0,3,3,0,3,3,3,3,3,3 },
{ 3,3,7,0,0,0,0,0,0,0,0,3,3,3,3,3,3,3,3,3,3,3,3,3,0,3,0,0,0,0,0,0,0,0,0,0,0,3,3,3,3,3,3 },
{ 6,0,0,0,0,3,0,0,3,0,0,10,3,3,3,3,3,3,3,3,3,3,3,3,3,3,3,3,3,3,3,3,3,3,3,3,3,3,3,3,3,3,3 },
{ 3,3,3,0,0,0,0,0,0,0,0,3,3,3,3,3,3,3,3,3,3,3,3,3,3,3,3,3,3,3,3,3,3,3,3,3,3,3,3,3,3,3,3 },
{ 3,3,3,3,8,3,9,9,9,9,3,3,3,3,3,3,3,3,3,3,3,3,3,3,3,3,3,3,3,3,3,3,3,3,3,3,3,3,3,3,3,3,3 },
