3,3,3,3,3,3,3,3,3,3,3,3,3,3,3,3,3,3,3,3,3,3,3,3,3,3,3,3,3,3,3,3,3,3,3,3,3,3,3,3,3,3,3
3,3,3,3,3,3,3,3,3,3,3,3,3,3,3,3,3,3,0,0,3,0,0,0,3,3,3,3,3,3,3,3,3,3,3,3,3,3,3,3,3,3,3
3,3,3,3,3,3,3,3,3,3,3,3,3,3,3,3,3,3,0,0,0,0,0,0,3,3,3,3,3,3,3,3,3,3,3,3,3,3,3,3,3,3,3
3,3,3,3,3,3,3,3,3,3,3,3,0,0,0,0,0,3,0,0,0,0,0,0,3,3,3,3,3,3,3,3,3,3,3,3,3,3,3,3,3,3,3
3,3,3,3,3,3,3,3,3,3,3,3,0,0,0,0,0,3,0,0,3,3,0,3,3,3,3,3,3,3,3,3,3,3,3,3,3,3,3,3,3,3,3
3,3,3,3,3,3,3,3,3,3,3,3,0,0,3,0,0,3,0,0,3,0,0,0,0,0,0,0,3,3,3,3,3,3,3,3,3,3,3,3,3,3,3
3,3,3,3,3,3,3,3,3,3,3,3,0,0,0,0,0,3,0,0,3,3,3,3,3,3,3,0,3,3,3,3,3,3,3,3,3,3,3,3,3,3,3
3,3,3,3,3,3,3,3,3,3,3,3,0,0,3,0,0,3,0,0,3,3,3,3,3,3,0,0,0,0,0,0,3,0,3,3,3,3,3,3,3,3,3
3,3,3,3,3,3,3,3,3,3,3,3,0,0,0,0,0,3,0,0,3,3,3,3,3,3,0,0,0,0,0,0,0,0,3,3,3,3,3,3,3,3,3
3,3,3,3,3,3,3,3,3,3,3,3,0,0,0,0,0,3,0,0,3,3,3,3,3,3,3,3,3,3,3,3,0,0,3,3,3,3,3,3,3,3,3
3,3,3,3,3,3,3,3,3,3,3,3,3,3,3,0,3,3,0,0,3,3,3,3,3,3,0,0,0,0,0,0,0,0,3,3,3,3,3,3,3,3,3
3,3,3,3,3,3,3,3,3,3,3,3,3,3,0,0,0,3,0,0,3,3,3,3,3,3,0,0,0,0,0,0,3,0,3,3,3,3,3,3,3,3,3
3,3,3,3,3,3,3,3,3,3,3,3,3,3,0,0,0,0,0,0,3,3,3,3,3,3,3,3,3,3,3,3,3,0,3,3,3,3,3,3,3,3,3
3,3,3,0,0,0,3,3,3,3,3,3,3,3,0,0,0,0,0,0,3,3,3,3,3,3,0,0,0,0,0,0,0,0,3,3,3,0,0,0,0,0,3
3,3,3,0,0,0,3,3,3,3,3,3,3,3,0,0,0,3,0,0,3,3,3,3,3,3,0,3,3,3,3,3,3,3,3,3,3,0,0,0,3,3,3
3,3,3,0,0,0,3,3,3,3,3,3,3,3,3,0,3,3,0,0,3,3,3,3,3,3,0,0,0,0,0,0,3,3,3,3,3,0,0,0,3,3,3
3,3,3,0,0,0,3,3,3,3,3,3,3,3,0,0,0,3,0,0,0,0,3,3,3,3,0,3,0,0,3,0,3,3,3,3,3,0,0,0,3,3,3
3,3,3,0,0,0,3,3,3,3,3,3,3,3,0,0,0,0,0,0,0,0,3,3,3,3,0,3,0,0,3,0,3,3,3,3,3,3,0,3,3,3,3
3,3,3,0,0,0,0,0,0,0,0,0,0,3,0,0,0,0,0,0,0,0,3,3,3,3,0,0,0,0,0,0,3,3,3,3,3,0,0,0,3,3,3
3,3,3,0,0,0,3,0,0,0,0,0,0,3,0,0,0,3,0,0,0,0,3,3,3,3,3,3,3,0,0,3,3,0,0,0,0,0,0,0,3,3,3
3,3,3,0,0,0,3,3,3,3,3,0,0,3,3,0,3,3,0,0,0,0,3,0,0,0,0,0,0,0,0,0,3,0,0,0,3,0,0,0,3,3,3
3,3,3,0,0,0,3,0,0,0,3,0,0,3,0,0,0,3,0,0,0,0,3,3,0,3,3,3,3,3,3,3,3,3,3,3,3,0,3,3,3,3,3
3,3,3,0,0,0,0,0,0,0,3,0,0,0,0,0,0,3,0,0,0,0,3,0,0,0,0,0,0,0,0,0,3,0,0,0,0,0,0,3,3,3,3
3,3,3,0,0,0,3,0,0,0,3,0,0,3,0,0,0,3,0,0,3,3,3,0,0,0,0,0,0,0,0,0,3,0,0,0,0,0,0,3,3,3,3
3,3,3,3,0,3,3,3,3,3,3,3,3,3,3,3,3,3,3,3,3,3,3,3,0,3,3,0,3,3,3,3,3,0,3,3,0,3,3,3,3,3,3
3,3,7,0,0,0,0,0,0,0,0,3,3,3,3,3,3,3,3,3,3,3,3,3,0,3,0,0,0,0,0,0,0,0,0,0,0,3,3,3,3,3,3
6,0,0,0,0,3,0,0,3,0,0,3,3,3,3,3,3,3,3,3,3,3,3,3,3,3,3,3,3,3,3,3,3,3,3,3,3,3,3,3,3,3,3
3,3,3,0,0,0,0,0,0,0,0,3,3,3,3,3,3,3,3,3,3,3,3,3,3,3,3,3,3,3,3,3,3,3,3,3,3,3,3,3,3,3,3
3,3,3,3,8,3,9,9,3,3,3,3,3,3,3,3,3,3,3,3,3,3,3,3,3,3,3,3,3,3,3,3,3,3,3,3,3,3,3,3,3,3,3